%%%%%%%%%%%%%%%%%%%%%%%%%%%%%%%%%%%%%%%%
% . . . . . .  % . .  . %  . . . . . . %
% o%%%  %  %%  %  %%%%  %  %%  %  %%% o%
% . . . % . . . . . G. . . . . % . . . %
%%%%  %%%  %%%%%  %%%%  %%%%%  %%%  %%%%
% . . . . . .  % . .  . %  . . . . . . %
%  %%%  %  %%  %  %%%%  %  %%  %  %%%  %
% . . . % . . . . %  % . . . . % . . . %
%%%%  %%%  %%%%%  %%%%  %%%%%  %%%  %%%%
% . . . . . .  % .  . . %  . . . . . . %
%  %%%  %  %%  %  %%%%  %  %%  %  %%%  %
% . . . % . . . . .  . . . . . % . . . %
%%%%  %%%  %%%%%  %%%%  %%%%%  %%%  %%%%
% . . . . . .  % . P. . %  . . . . . . %
% o%%%  %  %%  %  %%%%  %  %%  %  %%% o%
% . . . % . . . . .  . . . . . % . . . %
%%%%%%%%%%%%%%%%%%%%%%%%%%%%%%%%%%%%%%%%
                                                        
                                        
